{
	"mapdim"     : {"w":32, "h":24},
	"tiledim"    : {"w":32, "h":32},
	"startpoint" : {"x":-1, "y":8},
	"startore"   : 200,
	"tileset":
	[
		{"name": "grass", "animation":"tile_grass"},
		{"name": "dirt", "animation":"tile_dirt"}
	],
	"tilemap":
	[
		0,0,0,0,0,0,0,0,0,0,0,0,0,0,0,0,0,0,0,0,0,0,0,0,0,0,0,0,0,0,0,0,
		0,0,0,0,0,0,0,0,0,0,0,0,0,0,0,0,0,0,0,0,0,0,0,0,0,0,0,0,0,0,0,0,
		0,0,0,0,0,0,0,0,0,0,0,0,0,0,0,0,0,0,0,0,0,0,0,0,0,0,0,0,0,0,0,0,
		0,0,0,0,0,0,0,0,0,1,1,1,1,0,0,0,0,0,0,0,0,0,0,0,0,0,0,0,0,0,0,0,
		0,0,0,0,0,0,0,0,0,1,0,0,1,0,0,0,0,0,0,0,0,0,0,0,0,0,0,0,0,0,0,0,
		0,0,0,0,0,0,0,0,0,1,0,0,1,0,0,0,0,0,0,0,0,0,0,0,0,0,0,0,0,0,0,0,
		0,0,0,0,0,0,0,0,0,1,0,0,1,0,0,0,0,0,0,0,0,0,0,0,0,0,0,0,0,0,0,0,
		0,0,0,0,0,0,0,0,0,1,0,0,1,0,0,0,0,0,0,0,0,0,0,0,0,0,0,0,0,0,0,0,
		1,1,1,1,1,1,1,1,1,1,0,0,1,0,0,0,0,0,0,0,0,0,0,0,0,0,0,0,0,0,0,0,
		0,0,0,0,0,0,0,0,0,0,0,0,1,0,0,0,0,0,0,0,0,0,0,0,0,0,0,0,0,0,0,0,
		0,0,0,0,0,0,0,1,1,1,1,1,1,0,0,0,0,0,0,0,0,0,0,0,0,0,0,0,0,0,0,0,
		0,0,0,0,0,0,0,1,0,0,0,0,0,0,0,0,0,0,0,0,0,0,0,0,0,0,0,0,0,0,0,0,
		0,0,0,0,0,0,0,1,1,1,1,1,1,1,1,1,1,1,1,1,1,0,0,0,0,0,0,0,0,0,0,0,
		0,0,0,0,0,0,0,0,0,0,0,0,0,0,0,0,0,0,0,0,1,0,0,0,0,0,0,0,0,0,0,0,
		0,0,0,0,0,0,0,0,0,0,0,0,0,0,0,0,0,0,0,0,1,0,0,1,1,1,1,1,1,0,0,0,
		0,0,0,0,0,0,0,0,0,0,0,0,0,0,0,0,0,0,0,0,1,0,0,1,0,0,0,0,1,0,0,0,
		0,0,0,0,0,0,0,0,0,0,0,0,0,0,0,0,0,0,0,0,1,0,0,1,0,0,0,0,1,0,0,0,
		0,0,0,0,0,0,0,0,0,0,0,0,0,0,0,0,0,0,0,0,1,0,0,1,0,0,0,0,1,0,0,0,
		0,0,0,0,0,0,0,0,0,0,0,0,0,0,0,0,0,0,0,0,1,0,0,1,0,0,0,0,1,0,0,0,
		0,0,0,0,0,0,0,0,0,0,0,0,0,0,0,0,0,0,0,0,1,0,0,1,0,0,0,0,1,0,0,0,
		0,0,0,0,0,0,0,0,0,0,0,0,0,0,0,0,0,0,0,0,1,1,1,1,0,0,0,0,1,0,0,0,
		0,0,0,0,0,0,0,0,0,0,0,0,0,0,0,0,0,0,0,0,0,0,0,0,0,0,0,0,1,0,0,0,
		0,0,0,0,0,0,0,0,0,0,0,0,0,0,0,0,0,0,0,0,0,0,0,0,0,0,0,0,1,1,1,1,
		0,0,0,0,0,0,0,0,0,0,0,0,0,0,0,0,0,0,0,0,0,0,0,0,0,0,0,0,0,0,0,1
	],
	"waypoints" :
	[
		{"dx":9, "dy":0}
	],
	"towers":
	[
		{"type":"base", "pos":[512,384]},
		{"type":"miner", "pos":[532,404]}
	],
	"enemywaves":
	[
		{"spawnradius": 600, "spawninterval":0.2, "enemytype": "UFO", "enemycount":2, "targettype":"base"},
		{"spawnradius": 400, "spawninterval":1.0, "enemytype": "UFO", "enemycount":100, "targettype":"base"}
	],
	"oredeposits":
	[
		{"type":"ore_large", "pos":[300,300]},
		{"type":"ore_large", "pos":[320,310]},
		{"type":"ore_large", "pos":[340,320]},
		{"type":"ore_medium", "pos":[200,200]},
		{"type":"ore_medium", "pos":[210,210]},
		{"type":"ore_medium", "pos":[200,210]},
		{"type":"ore_medium", "pos":[220,200]},
		{"type":"ore_medium", "pos":[230,200]},
		{"type":"ore_medium", "pos":[240,230]},
		{"type":"ore_small", "pos":[100,100]},
		{"type":"ore_small", "pos":[120,100]},
		{"type":"ore_small", "pos":[100,110]},
		{"type":"ore_small", "pos":[120,110]},
		{"type":"ore_small", "pos":[100,110]},
		{"type":"ore_small", "pos":[120,120]}
	]
}